3 Contributors2017 Listening Log | Izeezus LyricsSongs
Bed Yeezy Season 5 | Kanye West ft. The Dream
Hypnotised | Coldplay
Sky Walker | Miguel ft. Travis Scott
Rubbin Off The Paint | YBN Nahmir
Biking | Frank Ocean ft. Jay-Z, Tyler the Creator
Melo Ball 1 | Lonzo Ball ft. Kenneth Paige
Up All Night | Surf Dads
Try This | Necklace
Anyone Who Knows What Love Is | Irma Thomas
Stars In The Ceiling | Quavo
Mans Not Hot | Michael Dapaah
444+222 | Lil Uzi Vert
Beat My Face | Rico Nasty
Feels So Good | A$AP MOB
Wrong | A$AP Mob ft. A$AP Rocky & A$AP Ferg
Killamonjaro | Killy
Lil Thing | Knox Fortune
High Tolerance | Ameer Vann
Almost There | Twelve'Len ft. Allan Kingdom
Love Scars | Trippie Redd
Uh Oh, Thots! | XXXTentacion & Trippie Redd
Catch Me Outside | Ski Mask the Slump God
Butterfly Effect | Travis Scott
Bodak Yellow | Cardi B
Sway | Nexxthursday ft. Quavo, Lil Yachty
Red Roses | Lil Skies ft. Landon Cube
It's Everyday Bro | Jake Paul ft. Team 10
Pull Up Wit Ah Stick | SahBabii ft. Loso Loaded
Castle on the Hill | Ed Sheeran
Made in China | Higher Brothers ft. Famous Dex
As If It's Your Last | BLACKPINK
Everyday We Lit | YFN Lucci ft. PNB Rock
Fiji | Pollari
Poppin | Rico Nasty
Villains Freestyle | Lil Pint
Four of a Kind | Magic Hippies
''Stay'100'' | Smooky MarGielaa
Cool | Zack Villere
FOLLOW | BROCKHAMPTON
Witchblades | Lil Peep & Lil Tracy
Friends | Justin Bieber & Bloodpop
Everything 1k | DC The Don
Harden the Paint | Foster The People
Turn Me Down | Jess Connelly
500 Benz | Joey Bada$$
The Race | Tay-K
Bank Account | 21 Savage
Kilo | Lil Durk & Doughboy
Benz Truck | Lil Peep
Crew | GoldLink ft. Brent Faiyaz and Shy Glizzy
TEMPLE_STAGE01 - SYLLABUS
Overwhelming - Matt OX
LAMB | BROCKHAMPTON
Forever Young | Lil Yachty & Diplo
Patty Cake | Kodak Black
Tunnel Vision | Kodak Black
Slide | Calvin Harris ft. Frank Ocean & Migos
Curve | Gucci Mane ft. The Weeknd
Some Way | NAV ft. The Weeknd
No Flag | London On Da Track ft. 21 Savage, Offset & Nicki Minaj
I Get The Bag | Gucci Mane ft. Migos
Plain Jane | A$AP Ferg
Red Bottom Sky | Yung Lean
First World Problems | Chance The Rapper ft. Daniel Caesar
Yes You Were | Land of Talk
Overdose | Lil Zubin & Wicca Phase Springs Eternal
Pills & Automobiles | Chris Brown ft. Yo Gotti, A Boogie Wit Da Hoodie & Kodak Black
Pink And Green | Roy Purdy
Mafia Business | 03 GREEDO
Snot Thot | Kodak Black
Pretty Girl | Clairo
Stickerbrush Symphony | David Wise (Donkey Kong Country 2: Diddy's Kong-Quest)
Aquatic Ambience | David Wise
Bali | 88GLAM ft. NAV
The Way Life Goes | Lil Uzi Vert ft. Nicki Minaj
Male Prima Donna | Subtle Sexuality
Big Enough | Kirin J Callinan ft. Alex Cameron, Jimmy Barnes & Molly Lewis
Insomnia | Ethan Avenue
Family Don't Matter | Young Thug
Female | Keith Urban
Call it What You Want | Taylor Swift
Gorgeous | Taylor Swift
Come Back Barack | De-Von-Tre
Get Off | Lonzo Ball
BBB | Lonzo Ball
Super Saiyan | Lonzo Ball
Motorsport | Migos ft. Cardi B & Nicki Minaj
MISFIT | Honcho Da Savage ft. Smooky Margielaa
Torn | Natalie Imbruglia
GUMMO | Tekashi69
Wanted You | NAV & Lil Uzi Vert
Inner Visions | Timecop1983
Crystal Sky | fvde
DON'T WASTE YOUR TIME | KOLBY SILVA
Mr. Clean | Yung Gravy
Beast In Me | Geoffrey Stoner
Poor Old Soul | Orange Juice
Сини пътища | Маргарита Хранова
I'm A G | YBN Nahmir
Gucci Gang (Remix) | Joyner Lucas
I'm Not Racist | Joyner Lucas
Coupe | Bali Baby
5:55 | Sylvan LaCue
Sunset Glow | Frank Pleyer
Liquid Love | Roy Ayers
Summer Nights | Lonnie Smith
It's Changed | Lonnie Smith
Solstice | Brian Bennett
Forty Nine Reasons | Julius Brockington
dream (pt. 2) | Errol Reid
Something to Remember | Warner Drexler
Plastic Love | Maria Takeuchi
The Ballad For The Girl on the Moon | The Boats
Albums/Mixtapes/EPs
Restoration of an American Idol | Taylor Bennett
Saturation | BROCKHAMPTON
Saturation 2 | BROCKHAMPTON
Ctrl | SZA
Members Only, Vol. 3 | Members Only
ALL AMERIKKAN BADA$$ | Joey Bada$$
Damn. | Kendrick Lamar
More Life | Drake
After Laughter | Paramore
Culture | Migos
Self-Titled Album - Playboi Carti
Everybody | Logic
Self-Titled Mixtape | NAV
In Abundance (unofficial) | Playboi Carti
Sugar Trap | Rico Nasty
Trip | Jhene Aiko
17 | XXXTentacion
4:44 | Jay-Z
Freudian | Daniel Caesar
I'm Brain | Brain/Lil Dicky
Melodrama | Lorde
Paradise | Knox Fortune
ROY PABLO | Boy Pablo
Cozy Tapes Vol. 2 | A$AP MOB
Urameshi EP | Anonymuz
Aromanticism | Moses Sumney
Self-Titled Album | Lil Pump
Mr. Davis | Gucci Mane
Morning After | dvsn
4eva Is a Mighty Long Time | Big K.R.I.T.
SYRE | Jaden Smith
No Dope on Sundays | CyHi the Prince
Revival | Eminem
Utterances of the Heart | Childish Gambino (mc DJ)
The 1st | Willow
Without Warning | Metro Boomin & 21 Savage
Heartbreak on a Full Moon | Chris Brown
PEAK | Choker
Room Sessions | Scotty Apex
War and Leisure | Miguel
Say Less | Roy Wood$3Embed