3 ContributorsNew Music Friday 07/24/15 LyricsPrince - Stare
Disclosure - Omen feat. Sam Smith
Jessie J - Sorry to Interrupt feat. Jhene Aiko & Rixton
Meg Myers - Lemon Eyes
XYLÃ˜ - Afterlife
Jimi Charles Moody - The Woman
Clairity - Velcro
Big Black Delta - It's OK
Lianne La Havas - Green & Gold
Eliot Sumner - Firewood
Skylar Stecker - That's What's Up
Beat Connection - So Good
Nvdes - Unforgettable
Pure Bathing Culture - Pray for Rain
Bag Raiders - Waterfalls
Strange Talk - When It Feels So Good
Clairity - DNA
Moon Taxi - Make Your Mind Up
Dej Loaf - We Winnin'
Travis Barker - 100 feat. Kid Ink, Ty Dolla $ign, Tyga & IamSu!
Foals - Mountain At My Gates
Kurt Vile - Pretty Pimpin
Jahkoy - Still in Love feat. SPZRKT
Tove Styrke - ... Baby One More Time
MKTO - Afraid of the Dark
Prince Royce - Dangerous feat. Kid Ink
Young Thug - Pacifier
NERVO - The Other Boys feat. Kylie Minogue, Jake Shears & Nile Rogers
Circa Waves - My Love
Rayland Baxter - Mr. Rodriguez
Gibbz - Love Again
Langhorne Slim & The Law - Life's a Bell
Night Beds - Corner
New Found Glory - Vicious Love feat. Hayley Williams
Lamb of God - Embers feat. Chino Moreno
White Reaper - Pills
Jim Adkins - I Will Go
Health - MEN TODAY
Cleopold - Down in Flames
Oslo Parks - Slipping Away
Leon Bridges - Smooth Sailin' (Live from Spotify Session)
Seinabo Sey - Pretend
Cheat Codes - Visions (Boehm Remix)
Dark Waves - Diamonds in the Dark
Bring Me The Horizon - Throne
Alice Glass - Stillbirth
On An On - Icon Love
Lauv - Reforget
Leona Lewis - Thunder
Rationale - Fuel to the Fire
Jill Scott - Closure
Transviolet - Girls Your Age
Family and Friends - Amadeus
SOAK - Be a noBody (Spotify Session)
Anteros - Anteros
Metric - Too Bad, So Sad
Kaskade - Disarm You feat. Ilsey
White Sea - Stay Young, Get Stoned
Dej Loaf - Hey There feat. Future
Tourist - Holding On feat. Josef Salvat & Niia
Lena Fayre - Do You Like That?
Here We Go Magic - Falling
Cloves - Don't You Wait
Day Wave - Total Zombie
Amason - Went to War (Spotify Sessions)
Julia Holter - Feel You2Embed