4 ContributorsNew Music Tuesday 05/26/15 LyricsThe Vaccines - 20/20
Alesso feat. Ryan Tedder - Scars
Jamie xx feat. Young Thug & Popcaan - I Know There's Gonna Be (Good Times)
The Weeknd - The Hills
Icona Pop feat. Erik Hassle - Emergency
A$AP Rocky - L$D
Refused - Françafrique
Of Monsters and Men - Hunger
Avicii - Waiting for Love
Jason Derülo feat. Matoma & Jennifer Lopez - Try Me
Grace - The Honey
Borgeous feat. Lights - Zero Gravity
Hudson Mohawke - Scud Books
Michael Brun feat. Rune RK & Denny White - See You Soon
Destroyer - Dream Lover
ROMANS - Uh Huh
José González - Open Book
Daniel Johns - Dissolve
Joy Williams - What a Good Woman Does
Andra Day - Forever Mine
Adam Lambert - Another Lonely Night
Five Knives - Wild Ones
NERVO - Haute Mess (ANNA Remix)
Boosie Badazz feat. J. Cole & Keyshia Cole - Black Heaven
Filous feat. James Hersey - How Hard I Try
Marc Scibilia - How Bad We Need Each Other
Pitbull feat. Sensato & Osmani Garcia "La Voz" - El Taxi
A$AP Rocky feat. ScHoolboy Q - Electric Body
50 Cent feat. Jeremih, T.I. & 2 Chainz - Get Low
Run the Jewels - Close Your Eyes
Joey Bada$$ - Paper Trail$
Son Lux - You Don't Know Me
Unknown Mortal Orchestra - Stage or Screen
Pokey LaFarge - Something in the Water
Josh Garrels - Born Again
Ty Dolla $ign feat. TeeCee4800, YG & Joe Moses - Only Right
Lil Durk feat. Logic - Tryna' Tryna'
Elijah Blake - Drop Dead Beautiful
Little Mix - Black Magic
Azekel - Mad About the Boy
Rob Thomas - Trust You
Jake Owen - Real Life
Kwamie Liv - Higher
Jaymes Young feat. Phoebe Ryan - We Won't
Dive In - Can't Hold Me Down
Anti-Flag feat. Tim Armstrong - Brandenburg Gate
The Go! Team - 'Til We Do It Together
Rivver feat. Milk & Bone - Am I Ok
Nero - Dark Skies
Dirty Fences - Judy (Don't Go)
Twin Peaks - In the Morning (In the Evening)
Hillsong United - Rule
Jon Foreman - Terminal
TRC feat. Princess Nyah - Butterflies
Elohim - She Talks Too MuchEmbed